{
    "name": "Basic Level 03",
    "board": [
        ".####.",
        ".####.",
        ".####.",
        ".####.",
        "..#...",
        "..#...",
        "###...",
        "###...",
        "###...",
        "#.....",
        "#.....",
        "######",
        "######",
        "..#G##",
        "..####"
    ],
    "start": {
        "row": 1,
        "col": 3,
        "orientation": "standing"
    }
}
