{
    "name": "Basic Level 06",
    "board": [
        "................",
        "................",
        ".....######.....",
        ".....#..###.....",
        ".....#..#####...",
        "######.....####.",
        "....###....##G#.",
        "....###.....###.",
        "......#..##.....",
        "......#####.....",
        "......#####.....",
        ".......###......",
        "................",
        "................"
    ],
    "start": {
        "row": 5,
        "col": 0,
        "orientation": "standing"
    },
    "bridges": [],
    "switches": []
}